SARV: 00000000
ASLB: 00000000
IMON: 00
IGDS: 00
CADL: 00
PADL: 00
CSTE: 0000
NSTE: 0000
DID9: 00000000
DIDA: 00000000
DIDB: 00000000
IBTT: 00
IPAT: 00
IPSC: 00
IBLC: 00
IBIA: 00
ISSC: 00
IPCF: 00
IDMS: 00
IF1E: 00
HVCO: 00
NXD1: 00000000
NXD2: 00000000
NXD3: 00000000
NXD4: 00000000
NXD5: 00000000
NXD6: 00000000
NXD7: 00000000
NXD8: 00000000
GSMI: 00
PAVP: 00
LIDS: 01
KSV0: 00000000
KSV1: 00
BBAR: 00000000
BLCS: 00
BRTL: 00
ALSE: 00
ALAF: 00
LLOW: 00
LHIH: 00
ALFP: 00
AUDA: 00000000
AUDB: 00000000
AUDC: 00000000
DIDC: 00000000
DIDD: 00000000
DIDE: 00000000
DIDF: 00000000
CCSA: 00000000
CCNT: 00000000
SGMD: 00
SGFL: 00
PWOK: 00
HLRS: 00
PWEN: 00
PRST: 00
CPSP: 00000000
EECP: 00
EVCP: 0000
XBAS: 00000000
GBAS: 0000
SGGP: 00
NVGA: 00000000
NVHA: 00000000
AMDA: 00000000
NDID: 00
DID1: 00000000
DID2: 00000000
DID3: 00000000
DID4: 00000000
DID5: 00000000
DID6: 00000000
DID7: 00000000
DID8: 00000000
OBS1: 00000000
OBS2: 00000000
OBS3: 00000000
OBS4: 00000000
OBS5: 00000000
OBS6: 00000000
OBS7: 00000000
OBS8: 00000000
LTRA: 00
OBFA: 00
LTRB: 00
OBFB: 00
LTRC: 00
OBFC: 00
SMSL: 0000
SNSL: 0000
P0UB: 00
P1UB: 00
P2UB: 00
EDPV: 00
NXDX: 00000000
DIDX: 00000000
PCSL: 00
SC7A: 00
DSEL: 00
ESEL: 00
PSEL: 00
MXD1: 00000000
MXD2: 00000000
MXD3: 00000000
MXD4: 00000000
MXD5: 00000000
MXD6: 00000000
MXD7: 00000000
MXD8: 00000000
PXFD: 00
EBAS: 00000000
HYSS: 00000000
